   ______ ______ ______ ______
  |      |      |      |      |
  |  01  |  02  |  03  |  04  |
  |______|______|______|______|
  |      |      |      |      |
  |  05  |  06  |  07  |  08  |
  |______|______|______|______|
  |      |      |      |      |
  |  09  |  10  |  11  |  12  |
  |______|______|______|______|
  |      |      |      |      |
  |  13  |  14  |  15  |  16  |
  |______|______|______|______|
